1111w1
110101
100001
110101
11x111
111111