111111111111111111111111111111111111111111
1x0000111111000000110000000000000000011
1110111111111110111000111111111111110011
1000000000000010111110000000000000010001
1011111111101011000001111111111110111011
1010001111101011111010000000111000111011
1010000000000011000000000000111110001011
1011111111111111111111111111111111110011
1000000000000000000000000000111111110011
1011111111111111111111111000111111110011
1010000000000111000000001000000000111011
1010111111110111111111111011111111111011
1000111000111111111111111000111111110011
1000111000100000000000000000000000000011
1010111000111111111111111111111111111111
1010000000000000000000000000000000000001
1w1111111111111111111111111111111111111111
111111111111111111111111111111111111111111